1111111111111
10P0C00000E11
1111111111111









